11111111
1ABCD0P1
1FGHIJC1
1KLMN0E1
11111111
