111111111111111111111
11N1CCCNCCCCCNCCC1N11
11N1C1CNCNCNCNC1C1N11
11N1C1CCCNCNCCC1C1N11
1N11C11111C11111C11N1
1N1NC1CCC1C1CCC1CN1N1
1N1CC1CNC1C1CNC1CC1N1
111NC1C111C111C1CN111
11CCC1CCC1C1CCC1CCC11
11CNC1C1C1E1C1C1CNC11
11CCC1CCCCPCCCC1CCC11
111111111111111111111
