11111111111
1CNCCCCCNC1
1CNCNCNCNC1
1CCCNCNCCC1
11111C11111
1NNN1C1NNN1
1NNN1C1NNN1
1NNN1C1NNN1
1NNN1C1NNN1
1NNN1E1NNN1
1NNN1P1NNN1
11111111111
