111111111111111111111
1111CCCNCCCCCNCCC1111
1111C1CNCNCNCNC1C1111
1111C1CCCNCNCCC1C1111
1111C11111C11111C1111
111NC1NNN1C1NNN1CN111
111CC1NNN1C1NNN1CC111
111NC1NNN1C1NNN1CN111
11CCC1NNN1C1NNN1CCC11
11CNC1NNN1E1NNN1CNC11
11CCC1NNN1P1NNN1CCC11
111111111111111111111
