11111
10001
100011111
1CEP1
11111
