11111111111111111111111111111111111
10000001000000000000000000000000001

10000001000000000000000000000000001
1P000000000000C000000000000000E0001
11111111111111111111111111111111111
