1111111
1C0E0C1
1110111
1110111
111P111
1111111
