1111111111111111111111111
111111111111E111111111111
11000C0010000000000000C11
1100111010010100C01110011
11001C100001C100001C00011
1100101000011100001110011
110000001000C000100C00011
111111111111P111111111111
1111111111111111111111111
