1111111
111E111
1C100C1
1110001
111P111
1111111
